10
50
00000000000000000000000000000000000000000000000000
01111141111114111111111111141111111111111111111410
01111111111111111100000111111111141110000011111110
01111111111111111000001111111111411100000111111110
01114111111111111111111111111114111000001111011110
01111111111110000011110011114111000001111111111100
01111111110000014111111114111000001111101111100000
01111110000011111111111111000001411111111110000010
01211114111111111411111111111111111114111111114130
00000100001000000000000000000000000000000000000000
